"......................"
"......................"
"......................"
"......................"
"......................"
"......................"
"......................"
"......................"
"...........""""......."
"...........".."......."
"....."""...".."......."
"...."..."..".."......."
""""""""""""""""""""""""
